111111111
10000C001
1000C0001
100C00PE1
111111111