111111111
100000001
100C00001
100000PE1
111111111