111111111111111111
10P001000000010101
100000000000000001
100C0000000E100001
111111111011111111
101000000000000001
100000000000000001
100C00000000000001
111111111110011111
101000000000000001
100000000000000001
100C00000000000001
111111111111111111