111111111
100000001
100000001
100000PE1
111111111