111111111
1P000C001
1000C0001
100C000E1
111111111