111111111111
100P01110111
100000100001
100C0000E001
100000C00001

111111111111