111111
100101
1P1001
100000
1C0E01
111111