111111111111111111111111111111111111
10P000000001110000000001110011110001
10000100000000C001000000100000000011
10000100C000000001111010101100011011
10001100000000000C100000111110000C01
10000000000000C001110001100000111101
10000000C000111100011101101100111001
100000000011111001C0000C001000C00001
100C00000001000001000111110001100001
11111111000000110111000C000011001101
101000010001110001001000111001111001
10000001000000C000001111100000001111
10000001C000000001111000101010101011
100011010000000001C0010000C011100001
10000001000000C001000111110000000001
10010000C0000000011000000C0000000001
100110000011111000001111100111000001
100C0000000E000001000000000000C00001
111111111111111111111111111111111111