11111111
1E100001
100000P1
1001E001
11001001
10001001
1C0001P1
11111111