111111
1P0011
100001
1E0101
1000P1
111111