111111111111111111
10P000000001110001
10000000000000C001
10000000C000000001
100011000000000001
10000000000000C001
10000000C000000001
100000000011111001
100C0000000E000001
111111111111111111