1111111111111111
1000000000000001
1000000000000001
1000000000E00001
10000C00000C0001
1000C00000000001
1000000000000001
1000000000P00001
10000C0000000001
1000000000000001
1111111111111111
