1111111111
1100011101
1P00111E01
100C001001
1111111111