11111111111111111111111111111111111111111111
10001P00000011110000000E00000000000C00001111
100011100C0000011100111110000111000010111011
10000010000010000000100011000000100001110011
1000000000000000C000000000111100000111111101
11111011000011100001111000000011000000000001
10000010000010000000100011000000100001110011
10000000000000000000000000000000000000000001
11111111111111111111111111111111111110000001
10000000000000000000011111000001111000000001
10111000001100000C00000011110000011001001111
10000010000010000000100011000000100001110011
100000C00000C000011000001C000000000000000011
10000011111000111000100110101010101010110011
11111111111111111111111111111111111111111111