111111
10C0C1
1E10C1
110001
1P0101
111111