111111111111111111111111111111111111111111111111111111111111111111111111
10100000000111000000000111001111000111111111000000110111000C000011001101
10000100000000C00100000010000000001110000000C000111100011101101000111001
10000100C000000001111010101100011011101000010001110001000000111001111001
10001100000000000C100000111110000C0000000001000000C000001111100000001111
10000000000000C001110001100000111101100C00000001000001000111110001100001
10000000C00011110001110110110011100000000000C000111100011101101100111001
100000000011111001C0000C001000C00000101000010001110001001000111001111001
100C0000000100000100011111000000000000000001000000C000001111100000001111
11111111000000110111000C00001100110010000000C000111100011101101100111001
101000010001110001001000111001111001100011010000000001C0010000C011100001
10000001000000C000001111100000001111101000010001110001001000111001111001
10000001C00000000111100010101010101110000001000000C001000111110000000001
100011010000000001C0010000C01110000000000000C000111100011101101100111001
10000001000000C00100011111000000000110000100C000000001111010101100011011
10010000C0000000011000000C0000000001100C00000001000001000111110001100001
100110000011111000001111100111000000101000010001110001001000111001111001
100C00000001000001000000000000C00001100110000011111000001111100111000001
111111111100000000000000000011111111110111111011111111001111101111100011
10P000000001110000000001110011110001100011010000000001C0010000C011100001
10000100000000C001000000100000000011101000010001110001001000111001111001
10000100C000000001111010101100011011101000010001110001001000111001111001
10001100000000000C100000111110000C00101000010001110001001000111001111001
10000000000000C001110001100000111101111111110000000000000111100000000001
10000000C00011110001110110110011100110000001000000C000001111100000001111
100000000011111001C0000C001000C00000001000010001110001001000111001111001
100C00000001000001000111110001100001100011010000000001C0010000C011100001
11111111000000110111000C00001100110110000000C000111100011101101100111001
10100001000111000100100011100111100110000001000000C001000111110000000001
10000001000000C0000011111000000011100000000000000000000000000000000E0001
10000001C00000000111100010101010101010000001000000C001000111110000000001
100011010000000001C0010000C01110000110000001000000C000001111100000001111
10000001000000C00100011111000000000010000000C000111100011101101100111001
10010000C0000000011000000C0000000001100C00000001000001000111110001100001
10011000001111100000111110011100000011111111000000110111000C000011001101
100C00000001000001000000000000C00001100110000011111000001111100111000001
111111111111111111111111111111111111111111111111111111111111111111111111